10 6
10 10

1 2 3 1 1 5 1 2 1 3
3 1 2 1 3 1 2 1 3
1 1 1 1 1 1 1 2 1 3
1 1 1 1 1 1 2 1 3
1 1 1 1 1 1 1 2 1 3
1 1 1 1 1 1 2 1 3

1 2 3 4 1 1 2 1 3
1 1 1 1 1 1 1 2 1 3
1 2 1 1 1 1 2 1 3
1 1 5 1 1 1 1 2 1 3